------------------------------------------------------------------------
-----------------WW-----WWWW--------------------------------------------
--------------WWWWW-WWWWWWWWWW---------------------W--------------------
------------W-WWWW-WWWWWWWWWW-----------------------W-------------------
............W.W.W..WWWWWWWWW-----------------W------WW------------------
---------------------WWWWWWW---------------W------WWWW------------------
--------WWWW---WWW----WWWWWW------------------WWWWWWWWWWWW-WWW----------
-WWWWWWWWW-------WWW--WWWWW---------WWWW-----WWWWWWWWWWWWWWWWWWWWWWW----
WWWWWWWWWWWWWWWW--WW--WWW---WW-----WWWW--WWWWWWWWWWWWWWWWWWWWWWWWWWWWW--
W-WWWWWWWWWWWWWW---W--WW----------WW-WWWWWWWWWWWWWWWWWWWWWWWWWWWWWWW----
----WWWWWWWWWW---WWW-------------WWW--WWWWWWWWWWWWWWWWWWWWWWWWW-W-------
------WWWWWWWWW--WWW-----------W--WW-WWWWWWWWWWWWWWWWWWWWWW----W--------
-------WWWWWWWWWWWWWW-----------WWWWWWWWWWWWWWWWWWWWWWWWWWWWW--W--------
--------WWWWWWWWWWWW-W----------WWWWWWWWWWWWWWWWWWWWWWWWWWWWW-----------
--------WWWWWWWWWWWW------------WWWWWW-WWWWWWWWWWWWWWWWWWWW-------------
--------WWWWWWWWWW-------------WW--WWW-WWWWWWWWWWWWWWWWWWW--------------
---------WWWWWWWWW-------------W--W---WWWWWWWWWWWWWWWWWW-W--------------
---------WWWWWWWW--------------WWWW----WWWWWWWWWWWWWWWWW----------------
-----------WWW--W-------------WWWWWWWWWWWW-WWWWWWWWWWWWW----------------
------------W----------------WWWWWWWWWWWWWWW--WWWWWWWWW-----------------
------------WWW---W----------WWWWWWWWWWW-WWW---WW--WW-------------------
---------------W-------------WWWWWWWWWWWWW-----W----WW------------------
----------------WWWWW---------WWWWWWWWWWWW------------------------------
-----------------WWWWW------------WWWWWWWW---------WW--W----------------
-----------------WWWWWWW----------WWWWWWW-----------W-W-W-W-------------
-----------------WWWWWWWWW---------WWWWW-------------W------W-----------
-----------------WWWWWWWW----------WWWWW--------------------W-----------
------------------WWWWWWW----------WWWWW-W---------------WWWW-----------
-------------------WWWWW-----------WWWW--W-------------WWWWWWW----------
-------------------WWWW------------WWWW----------------WWWWWWWW---------
------------------WWWW--------------WWW----------------WWWWWWW----------
------------------WWW---------------------------------------WW----------
------------------WW----------------------------------------------------
------------------WW----------------------------------------------------
------------------W-----------------------------------------------------
------------------W-----------------------------------------------------
------------------------------------------------------------------------
------------------------------------------------------------------------