. . . . . . . . . . . . . . . . . . . . . . . . . . . . . .
. . . . . . . . .#######. . . . . . . . . . . . . . . . . .
. . . . . . . .#. .#### . . . ####. . .###############. . .
. . . ########. ##. ##. . . ######################### . . .
. . . . ##########. . . . ######################. . . . . .
. . . . .######## . . . .   ################### . . . . . .
. . . . . ### .   . . . .#####. ##############. # . . . . .
. . . . . . ##### . . . .#######. ##########. . . . . . . .
. . . . . . .###### . . . .#### . . . . .## . . . . . . . .
. . . . . . . ##### . . . .#### # . . . . . ##### . . . . .
. . . . . . . ### . . . . . ##. . . . . . . . ### .#. . . .
. . . . . . . ##. . . . . . . . . . . . . . . . . . . . . .
. . . . . . . . . . . . . . . . . . . . . . . . . . . . . .
